1111111111111111111111111111111111111111111111111111111111111111111111111111111111111111111111111111
1222221222221122122222122222112122222122222112212222212222211221222221222221122112212222212222211221
1222221222222222122222122222222122222122222222212222212222222221222221222222222122212222212222222221
1222221222222222122222122222222122222122222222212222212222222221222221222222222122212222212222222221
1222221222111111122222122211111122222122211111112222212221111111222221222111111111112222212221111111
1222222222222222122222222222222122222222222222212222222222222221222222222222222122212222222222222221
1111122222222222111112222222222111112222222222211111222222222221111122222222222122211111222222222221
1221222222222222122122222222222122122222222222212212222222222221221222222222222122212212222222222221
1221222111111222122122211111122122122211111122212212221111112221221222111111222122212212221111112221
1221222222221222122122222222122122122222222122212212222222212221221222222221222222222212222222212221
1221222222221222122122222222122122122222222122212212222222212221221222222221222222222212222222212221
1221222222221222122122222222122222122222222122222212222222212221221222222221222222222212222222212221
1221221122221222122122112222122222122112222122222212211222212221221221122221222122212212211222212221
1222221222221222122222122222122122222122222122212222212222212221222221222221222122212222212222212221
1222221222221222122222122222122122222122222122212222212222212221222221222221222122212222212222212221
1111111112211111111111111221111111111111111111111111111111111221111111111111111111111111111222111111
1222221222221122122222122222112122222122222112212222212222211221222221222221122112212222212222211221
1222221222222222122222122222222122222122222222212222212222222221222221222222222122212222212222222221
1222221222222222122222122222222122222122222222212222212222222221222221222222222122212222212222222221
1222221222111111122222122211111122222122211111112222212221111111222221222111111112212222212221111111
1222222222222222122222222222222122222222222222212222222222222221222222222222222122212222222222222221
1111122222222222111112222222222111112222222222211111222222222221111122222222222222211111222222222221
1221222222222222122122222222222122122222222222212212222222222221221222222222222222212212222222222221
1221222111111222122122211111122122122211111122212212221111112221221222111111222222222212221111112221
1221222222221222122122222222122122122222222122222212222222212221221222222221222122212212222222212221
1221222222221222122122222222122222122222222122222212222222212221221222222221222111111111112222111111
1221222222221222122122222222122222122222222122222212222222212221221222222221222122212222212222211221
1221221122221222222122112222122122122112222122212212211222212221221221122221222122212222212222222221
1222221222221222222222122222122122222122222122212222212222212221222221222221222122212222212222222221
1222221222221222122222122222122122222122222122212222212222212221222221222221222111112222212221111111
1111111111111111111222111111111111111111111111111111111222111111112211111111111122212222222222222221
1222221222221122122222122222112122222122222112212222212222211221222221222221122122211111222222222221
1222221222222222122222122222222122222122222222212222212222222221222221222222222122212212222222222221
1222221222222222122222122222222122222122222222212222212222222221222221222222222122212212221111112221
1222221222111111122222122211111122222122211111112222212221111111222221222111111122212212222222212221
1222222222222222122222222222222122222222222222212222222222222221222222222222222122212212222222212221
1111122222222222111112222222222111112222222222211111222222222221111122222222222122212212222222212221
1221222222222222122122222222222122122222222222212212222222222221221222222222222222222212211222212221
1221222111111222122122211111122122122211111122212212221111112221221222111111222222222222212222212221
1221222222221222122122222222122222122222222122212212222222212221221222222221222122222222212222212221
1221222222221222222122222222122222122222222122222212222222212222221222222221222112211122211111111111
1221222222221222222122222222122122122222222122222212222222212222221222222221222112212222212222211221
1221221122221222122122112222122122122112222122212212211222212222221221122221222122212222212222222221
1222221222221222122222122222122122222122222122212222212222212221222221222221222122212222212222222221
1222221222221222122222122222122122222122222122212222212222212221222221222221222111112222212221111111
1111111111111222111111111111111111111111111111111111111112211111111111111111111122212222222222222221
1221222222222222122122222222222212212222222222221221111122222222222111112222222222211111222222222221
1221222111111222122122211111122212212221111112221221221222222222222122122222222222212212222222222221
1221222222221222122122222222122212212222222212221221221222111111222222122211111122212212221111112221
1221222222221222122122222222122212212222222212221221221222222221222222122222222122222212222222212221
1221222222221222122122222222122212212222222212221111221222222221222222122222222122222212222222212221
1221221122221222122122112222122212212211222212221221221222222221222222122222222122222212222222212221
1222221222221222122222122222122212222212222212221221221221122221222122122112222122222212211222212221
1222221222221222122222122222122212222212222212221221222221222221222122222122222122212222212222212221
1111111112211111111111111111111111111111111111111111111111111111111111111111111112212222212222212221
1222221222221122122222122222112212222212222211221222221222221122122222122222112211111111112222111111
1222221222222222122222122222222212222212222222221222221222222222122222122222222212212222212222211221
1222221222222222122222122222222212222212222222221222221222222222122222122222222212212222212222222221
1222221222111111122222122211111112222212221111111222221222111111122222122211111112212222212222222221
1222222222222222122222222222222222222222222222221222222222222222122222222222222211112222212221111111
1111122222222222111112222222222221111222222222221111122222222222111112222222222212212222222222222221
1221222222222222122122222222222222212222222222221221222222222222122122222222222212211111222222222221
1221222111111222122122211111122222212221111112221221222111111222122122211111122222212212222222222221
1221222222221222122122222222122212212222222212221221222222221222122122222222122222212212221111112221
1221222222221222122122222222122212212222222212221221222222221222222122222222122222212212222222212221
1221222222221222122122222222122212212222222212222221222222221222222122222222122222212212222222212221
1221221122221222122122112222122212212211222212222221221122221222222122112222122212212212222222212221
1222221222221222122222122222122212222212222212222222221222221222122222122222122212212212211222212221
1222221222221222122222122222122212222212222212221222221222221222122222122222122212212222212222212221
1111111122211111111111111111111111111111111111111111111122111111111111111111111112212222212222212221
1222221222221122122222122222112222222212222211221222221222221122122222122222112211111111111111111111
1222221222222222122222122222222222222212222222221222221222222222122222122222222212212222212222222221
1222221222222222122222122222222212222212222222221222221222222222122222122222222212212222212222222221
1222221222111111122222122211111112222212221111111222221222111111122222122211111111112222212221111111
1222222222222222122222222222222212222222222222221222222222222222122222222222222212212222222222222221
1111122222222222211112222222222211111222222222221111122222222222111112222222222212211111222222222221
1221222222222222222122222222222212212222222222221221222222222222122122222222222212212212222222222221
1221222111111222222122211111122212212221111112221221222111111222122122211111122222212212221111112221
1221222222221222222122222222122212212222222212222221222222221222122122222222122222222212222222212221
1221222222221222222122222222122212212222222212222221222222221222122122222222122222222212222222212221
1221222222221222122122222222122212212222222212222221222222221222122122222222122212212212222222212221
1221221122221222122122112222122212212211222212221221221122221222122122112222122212212212211222212221
1222221222221222122222122222122212222212222212221222221222221222122222122222122212212222212222212221
1222221222221222122222122222122212222212222212221222221222221222122222122222122212212222212222212221
1122211111111111111111111111111111222111111111111111111111111111111111111111111111111111111122211111
1222221222221122122222122222112212222212222211221222221222221122122222122222112212212222212222211221
1222221222222222122222122222222212222212222222221222221222222222122222122222222212212222212222222221
1222221222222222122222122222222212222212222222221222221222222222122222122222222212212222212222222221
1222221222111111122222122211111112222212221111111222221222111111122222122211111111112222212221111111
1222222222222222122222222222222212222222222222221222222222222222122222222222222212212222222222222221
1111122222222222111112222222222211111222222222221111122222222222111112222222222212211111222222222221
1221222222222222122122222222222212212222222222221221222222222222122122222222222212212212222222222221
1221222111111222222122211111122212212221111112222221222111111222222122211111122212212212221111112221
1221222222221222222122222222122212212222222212222221222222221222222122222222122212212212222222212221
1221222222221222222122222222122212212222222212222221222222221222222122222222122222222212222222212221
1221222222221222222122222222122212212222222212222221222222221222122122222222122222222212222222212221
1221221122221222222122112222122212212211222212221221221122221222122122112222122212212212211222212221
1222221222221222222222122222122212222212222212221222221222221222122222122222122212212222212222212221
1222221222221222222222122222122212222212222212221222221222221222122222122222122212212222212222212221
1111111111111111111111111111111111111111111111111111111111111111111111111111111111111111111111111111